"a" = (/turf/simulated/floor/dirty,/area/constructionsite)
"b" = (/turf/simulated/wall,/area/constructionsite)
"c" = (/obj/machinery/light{dir = 1},/turf/simulated/floor/dirty,/area/constructionsite)
"d" = (/obj/effect/landmark{name = "tdome1"},/turf/simulated/floor/dirty,/area/constructionsite)
"e" = (/obj/effect/floor_decal/industrial/hatch/yellow,/turf/simulated/floor/dirty,/area/constructionsite)
"f" = (/obj/machinery/light_switch{pixel_x = 25},/turf/simulated/floor/dirty,/area/constructionsite)
"g" = (/obj/machinery/light{icon_state = "tube1"; dir = 8},/turf/simulated/floor/dirty,/area/constructionsite)
"h" = (/obj/structure/ladder/up,/turf/simulated/floor/dirty,/area/constructionsite)
"i" = (/obj/machinery/light{icon_state = "tube1"; dir = 4},/turf/simulated/floor/dirty,/area/constructionsite)
"j" = (/obj/machinery/atmospherics/unary/vent_pump/on,/turf/simulated/floor/dirty,/area/constructionsite)
"k" = (/turf/simulated/wall/iron,/area/constructionsite)
"l" = (/obj/machinery/atmospherics/pipe/simple/visible{tag = "icon-intact (NORTHEAST)"; icon_state = "intact"; dir = 5},/turf/simulated/floor/dirty,/area/constructionsite)
"m" = (/obj/machinery/atmospherics/pipe/simple/visible{tag = "icon-intact (EAST)"; icon_state = "intact"; dir = 4},/turf/simulated/floor/dirty,/area/constructionsite)
"n" = (/obj/machinery/atmospherics/portables_connector{tag = "icon-map_connector (WEST)"; icon_state = "map_connector"; dir = 8},/obj/machinery/portable_atmospherics/canister/air,/turf/simulated/floor/dirty,/area/constructionsite)
"o" = (/obj/effect/wingrille_spawn/reinforced,/turf/simulated/floor/plating,/area/constructionsite)
"p" = (/obj/machinery/computer/shuttle_control{shuttle_tag = "Example"},/turf/simulated/floor/plating,/area/constructionsite)
"q" = (/obj/machinery/light_switch{pixel_x = -25},/turf/simulated/floor/dirty,/area/constructionsite)
"r" = (/obj/effect/landmark/start,/turf/simulated/floor/dirty,/area/constructionsite)
"s" = (/obj/structure/bed/chair{dir = 1},/obj/machinery/embedded_controller/radio/simple_docking_controller{id_tag = "example_shuttle_starboard"; pixel_x = 28},/obj/machinery/embedded_controller/radio/simple_docking_controller{id_tag = "example_shuttle_port"; pixel_x = -28},/obj/effect/shuttle_landmark/lower_level,/turf/simulated/floor/plating,/area/constructionsite)
"t" = (/obj/effect/landmark/test/safe_turf,/turf/simulated/floor/dirty,/area/constructionsite)
"u" = (/obj/machinery/atmospherics/pipe/simple/visible{tag = "icon-intact (SOUTHEAST)"; icon_state = "intact"; dir = 6},/turf/simulated/floor/dirty,/area/constructionsite)
"v" = (/obj/machinery/atmospherics/portables_connector{tag = "icon-map_connector (WEST)"; icon_state = "map_connector"; dir = 8},/obj/machinery/portable_atmospherics/canister/empty,/turf/simulated/floor/dirty,/area/constructionsite)
"w" = (/obj/machinery/door/airlock/external/bolted{frequency = 1379; id_tag = "example_shuttle_port_hatch"},/turf/simulated/floor/plating,/area/constructionsite)
"x" = (/obj/machinery/light,/turf/simulated/floor/plating,/area/constructionsite)
"y" = (/obj/machinery/door/airlock/external/bolted{frequency = 1379; id_tag = "example_shuttle_starboard_hatch"},/turf/simulated/floor/plating,/area/constructionsite)
"z" = (/obj/machinery/door/airlock/external/bolted{frequency = 1379; id_tag = "lower_level_dock_hatch"},/turf/simulated/floor,/area/constructionsite)
"A" = (/obj/machinery/embedded_controller/radio/simple_docking_controller{id_tag = "lower_level_dock"; pixel_x = -8; pixel_y = -25},/turf/simulated/floor,/area/constructionsite)
"B" = (/turf/simulated/floor,/area/constructionsite)
"C" = (/obj/machinery/atmospherics/unary/vent_scrubber/on{tag = "icon-map_scrubber_on (NORTH)"; icon_state = "map_scrubber_on"; dir = 1},/turf/simulated/floor/dirty,/area/constructionsite)
"D" = (/obj/effect/landmark{name = "JoinLate"},/turf/simulated/floor/dirty,/area/constructionsite)
"E" = (/obj/structure/cable{d2 = 2; icon_state = "0-2"; pixel_y = 0},/obj/machinery/power/apc{dir = 8; name = "west bump"; pixel_x = -24},/turf/simulated/floor/dirty,/area/constructionsite)
"F" = (/obj/structure/cable{d1 = 1; d2 = 2; icon_state = "1-2"; pixel_y = 0},/turf/simulated/floor/dirty,/area/constructionsite)
"G" = (/obj/structure/cable,/obj/machinery/power/debug_items/infinite_generator,/turf/simulated/floor/dirty,/area/constructionsite)
"H" = (/obj/machinery/light,/turf/simulated/floor/dirty,/area/constructionsite)
"I" = (/obj/effect/landmark/test/space_turf,/turf/simulated/floor/dirty,/area/constructionsite)

(1,1,1) = {"
aaaaaaaaaaaaaaaaaaaaaaaaaaaaaaaaaaaaaaaaaaaaaaaa
aaaaaaaaaaaaaaaaaaaaaaaaaaaaaaaaaaaaaaaaaaaaaaaa
aaaaaaaaaaaaaaaaaaaaaaaaaaaaaaaaaaaaaaaaaaaaaaaa
aaaaaaaaaaaaaaaaaaaaaaaaaaaaaaaaaaaaaaaaaaaaaaaa
aaaaaaaaaaaaaaaaaaaaaaaaaaaaaaaaaaaaaaaaaaaaaaaa
aaaaaaaaaaaaaaaaaaaaaaaaaaaaaaaaaaaaaaaaaaaaaaaa
aaaaaaaaaaaaaaaaaaaaaaaaaaaaaaaaaaaaaaaaaaaaaaaa
aaaaaaaaaaaaaaaaaaaaaaaaaaaaaaaaaaaaaaaaaaaaaaaa
aaaaaaaaaaaaaaaaaaaaaaaaaaaaaaaaaaaaaaaaaaaaaaaa
aaaaaaaaaaaaaaaaabbbbbbbbbbbbbbbaaaaaaaaaaaaaaaa
aaaaaaaaaaaaaaaaabaaacaaaaacaaabaaaaaaaaaaaaaaaa
aaaaaaaaaaaaaaaaabadddaebeaaaaabaaaaaaaaaaaaaaaa
aaaaaaaaaaaaaaaaabadddaeeeaaaafbaaaaaaaaaaaaaaaa
aaaaaaaaaaaaaaaaabgdddheeeaaaaibaaaaaaaaaaaaaaaa
aaaaaaaaaaaaaaaaabaaaaaaaaaajaabaaaaaaaaaaaaaaaa
aaaaaaaaaaaakkkaabaaaaaaaaaalmnbaaaaaaaaaaaaaaaa
aaaaaaaaaaaaopoaabqaaaaaraaaaaabaaaaaaaaaaaaaaaa
aaaaaaaaaaaaosobbbaaaataaaaaumvbaaaaaaaaaaaaaaaa
aaaaaaaaaaaawxyzABaaaaaaaaaaCaabaaaaaaaaaaaaaaaa
aaaaaaaaaaaakkkbbbgaDDDaaaaaaaibaaaaaaaaaaaaaaaa
aaaaaaaaaaaaaaaaabEaDDDaaaaaaaabaaaaaaaaaaaaaaaa
aaaaaaaaaaaaaaaaabFaDDDaaaaaaaabaaaaaaaaaaaaaaaa
aaaaaaaaaaaaaaaaabGaaHaaaaaHaaabaaaaaaaaaaaaaaaa
aaaaaaaaaaaaaaaaabbbbbbbbbbbbbbbaaaaaaaaaaaaaaaa
aaaaaaaaaaaaaaaaaaaaaaaaaaaaaaaaaaaaaaaaaaaaaaaa
aaaaaaaaaaaaaaaaaaaaaaaaaaaaaaaaaaaaaaaaaaaaaaaa
aaaaaaaaaaaaaaaaaaaaaaIaaaaaaaaaaaaaaaaaaaaaaaaa
aaaaaaaaaaaaaaaaaaaaaaaaaaaaaaaaaaaaaaaaaaaaaaaa
aaaaaaaaaaaaaaaaaaaaaaaaaaaaaaaaaaaaaaaaaaaaaaaa
aaaaaaaaaaaaaaaaaaaaaaaaaaaaaaaaaaaaaaaaaaaaaaaa
aaaaaaaaaaaaaaaaaaaaaaaaaaaaaaaaaaaaaaaaaaaaaaaa
aaaaaaaaaaaaaaaaaaaaaaaaaaaaaaaaaaaaaaaaaaaaaaaa
"}
